{
    vertices = [
        { id = "v1", point = {x = 0, y = 0}},
        { id = "v2", point = {x = -0.25, y = 0.25}},
        { id = "v3", point = {x = -0.25, y = -0.25}},
        { id = "v4", point = {x = 0.25, y = -0.25}},
        { id = "v5", point = {x = 0.25, y = 0.25}},
        { id = "v6", point = {x = 0.75, y = 0.5}},
    ],
    edges = [
        { id = "e1", p1 = {x = 0, y = 0}, p2 = {x = 0, y = 0}},
        { id = "e2", p1 = {x = 0, y = 0}, p2 = {x = 0, y = 0}},
        { id = "e3", p1 = {x = 0, y = 0}, p2 = {x = 0, y = 0}},
        { id = "e4", p1 = {x = 0, y = 0}, p2 = {x = 0, y = 0}},
        { id = "e5", p1 = {x = 0, y = 0}, p2 = {x = 0, y = 0}},
        { id = "e6", p1 = {x = 0, y = 0}, p2 = {x = 0, y = 0}},
        { id = "e7", p1 = {x = 0, y = 0}, p2 = {x = 0, y = 0}},
        { id = "e8", p1 = {x = 0, y = 0}, p2 = {x = 0, y = 0}},
        { id = "e9", p1 = {x = 0, y = 0}, p2 = {x = 0, y = 0}},
    ]
}
